s01000110000000
100010000101110
000111110100000
011100010111111
000101000100000
110101111101110
011100000001000
000011101111011
011000001000010
010011100011000
010100000000111
110000101110010
000010101000010
111000101111000
10001100100000f
