000000000000000
000000000011111
000000000010000
000000000010000
000000008110000
000000000100000
000000000100000
000000111100000
000000100000000
000000100000000
000000100000000
000000100000000
000000111110000
000000000010000
000000000011119