50111111110000
10001100000111
10111101101101
10000001101101
10111111100000
10010100100010
10010110001010
10110111111011
10000000000010
11111101111000
01111101000010
01000101111010
01010101111011
00010000000001
11111111111131